1,2,3,4,5,6,7,8,9,10,11,12,13,14,28,28,28,28,28,28
15,16,17,18,19,20,21,22,23,24,25,26,27,28,28,28,28,28,28,28
28,29,30,31,32,33,28,28,28,28,28,28,28,28,28,28,28,28,28,28
101,102,103,104,105,106,107,108,109,110,111,112,113,114,115,116,28,28,28,28
40,39,38,134,146,41,42,28,28,28,28,28,28,28,28,28,28,28,28,28
36,35,34,133,145,37,28,28,28,28,28,28,28,28,28,28,28,28,28,28
45,44,43,129,140,46,47,28,28,28,28,28,28,28,28,28,28,28,28,28
28,28,28,28,28,28,28,28,28,28,28,28,28,28,28,28,28,28,28,28
1,2,3,4,5,6,7,8,9,10,11,12,13,14,28,28,28,28,28,28