3,5,1,1,1,1,1,1,1,1
1,1,1,1,1,1,1,1,1,1
1,1,35,1,1,39,1,1,1,1
1,1,1,1,1,1,1,1,1,1
1,1,1,1,1,1,1,1,1,1
113,113,113,113,113,113,113,113,113,113
1,1,1,1,1,1,1,1,1,1
1,1,1,1,1,1,1,1,1,1