3,5,1,1,1,1,1,1,1,1
1,1,1,1,1,1,1,1,1,1
1,47,35,1,1,39,42,1,1,1
1,1,1,1,1,1,1,1,1,1
1,1,1,1,1,1,1,1,1,1
113,113,113,113,113,113,113,113,113,113
1,1,1,1,1,1,1,1,1,1
1,1,1,1,1,1,1,1,1,1