2,2,3,2,3,3,3,1,1,1,3,2,1,1,1,1,54,16,1,57
3,2,2,3,3,1,1,1,3,1,1,1,2,2,1,1,1,16,1,1
2,3,3,3,1,3,34,1,1,1,3,1,3,2,2,34,1,16,53,1
3,3,3,35,1,1,1,18,15,15,15,15,22,15,15,15,15,20,3,3
36,2,3,1,1,3,1,16,2,3,2,3,16,3,1,1,34,3,3,2
2,3,3,34,1,1,1,16,3,2,3,2,16,1,1,3,1,3,2,36
3,3,18,15,15,15,15,24,15,15,15,15,20,1,1,1,35,3,3,3
1,86,16,1,34,2,2,3,1,1,1,1,1,34,3,1,3,3,3,2
1,1,16,1,1,1,2,2,1,1,3,1,3,1,1,3,3,2,2,3
90,1,16,87,1,1,1,1,2,3,1,1,1,3,3,3,2,3,2,2