3,5,36,3,3,1,1,1,49,3,1,3,3
18,26,1,3,18,34,19,3,2,3,1,1,1
34,10,8,18,20,1,21,15,19,3,3,34,15
1,1,5,16,1,3,1,1,21,19,1,2,2
52,1,5,21,49,3,3,1,1,34,2,1,2
27,27,9,1,1,2,1,34,1,1,1,1,34
1,1,3,1,1,1,2,1,1,1,3,1,1
34,1,1,1,1,34,1,2,1,1,7,27,27
2,1,2,34,1,1,3,3,82,19,5,1,85
2,2,1,21,19,1,1,3,1,16,5,1,1
15,34,3,3,21,15,19,1,18,20,10,8,34
1,1,1,3,2,3,21,34,20,3,1,26,20
3,3,1,3,82,1,1,1,3,3,36,5,3